ssssssssssssssssssssssssssssssssssssssss
s                                      s
s                                      s
s                                      s
s     ssssssssssss    ssssssssssss     s
s     s                          s     s
s     s h                      h s     s
s                                      s
s                                      s
s     sss    ss ss ss ss ss    sss     s
s     s o o o o o o o o o o o o os     s
s     so o o o o o o o o o o o o s     s
s     sss    ss ss ss ss ss    sss     s
s                                      s
s                                      s
s     s h                      h s     s
s     s                          s     s
s     ssssssssssss    ssssssssssss     s
s                                      s
s                                      s
s                                      s
ssssssssssssssssssssssssssssssssssssssss
ssssssssssssssssssssssssssssssssssssssss